20 EHCI=2.0 (EHCI)
30 nec XHCI=3.0 (nec XHCI)
30 qemu XHCI=3.0 (qemu XHCI)
Allocation=分配
and if using graphics device passthrough it too needs UEFI=如果使用圖形設備直通，也需要UEFI
Are you sure=是否確定
Array must be started to view Virtual Machines=必須啟動陣列才能查看虛擬機
Autostart=自動啟動
Back=返回
Bus=總線
Capacity=容量
Change Icon=更改圖標
Cleanup=清理
Click and Select cdrom image to install operating system=單擊並選擇光盤映像以安裝操作系統
Config Folder=配置文件夾
Copy Paste Domain XML Configuration Here=在此處複製粘貼域XML 配置
CPU Mode=CPU 模式
CPUs=CPU
Create=創建
Creating=正在創建
define the amount memory=定義內存量
define the maximum amount of memory=定義最大內存量
define type of cpu presented to this vm=定義提供給此虛擬機的cpu 類型
description of virtual machine=虛擬機描述
Disk devices=磁盤設備
Download Folder=下載文件夾
Download, Click and Select virtio drivers image=下載，單擊並選擇virtio 驅動程序映像
Downloading=正在下載
eg=例如
Emulated=模擬
Extracting=正在提取
Folder to save the LibreELEC image to=用於保存LibreELEC 映像的文件夾
Folder to save the OpenELEC image to=用於保存OpenELEC 映像的文件夾
Form View=表單視圖
free=可用
Graphics Card=顯卡
Graphics ROM BIOS=圖形ROM BIOS
Graphics=圖形
Host Passthrough=主機直通
Hyperv tweaks for Windows=針對Windows Hyper-V 的調整
Hyper-V=Hyper-V
i440fx will work for most=i440fx 適用於大多數
Icon=圖標
Initial=初始
Invalid VM to edit=要編輯的無效虛擬機
ISO storage path doesnt exist, please create the user share or empty folder first=ISO storage path doesn't exist, please create the user share (or empty folder) first
ISO storage path doesnt exist=ISO 存儲路徑不存在
ISO storage path was empty=ISO 存儲路徑為空
keyboard for VNC=VNC 鍵盤
LibreELEC Version=LibreELEC 版本
LibreELEC=LibreELEC
Libvirt Service failed to start=Libvirt 服務無法啟動
Logical CPUs=邏輯CPU
Machine=機器
Manual=手動
Max=最大值
MD5 verification failed, your download is incomplete or corrupted=MD5 驗證失敗，您的下載未完成或已損壞
mount tag inside vm=虛擬機掛載標籤
My Workstation=我的工作站
name of mount tag inside vm=虛擬機掛載標籤名稱
Name of virtual machine=虛擬機名稱
Network Bridge=網絡橋接
Network MAC=網絡MAC
No Virtual Machines installed=未安裝虛擬機
None available=無可用
Not enough free space, need at least=可用空間不足，至少需要
Not running=沒有運行
OpenELEC Version=OpenELEC 版本
OpenELEC=OpenELEC
OS Install CDRom Bus=操作系統安裝光盤總線
OS Install ISO=操作系統安裝ISO
Other PCI Devices=其他PCI 設備
OVMF requires a UEFI-compatable OS=OVMF 需要與UEFI 兼容的操作系統
OVMF=OVMF
password for VNC=VNC 密碼
path of Unraid share=Unraid 共享路徑
path on Unraid share to save LibreELEC settings=用於保存LibreELEC 設置的Unraid 共享路徑
path on Unraid share to save OpenELEC settings=用於保存OpenELEC 設置的Unraid 共享路徑
Path to ROM BIOS file=ROM BIOS 文件路徑
Please choose a folder the LibreELEC image will download to=請選擇LibreELEC 映像將下載到的文件夾
Please choose a folder the OpenELEC image will download to=請選擇OpenELEC 映像將下載到的文件夾
Pop-up Blocker is enabled Please add this site to your exception list=Pop-up Blocker is enabled! Please add this site to your exception list
Primary=主要
Q35 for a newer machine model with PCIE=適用於配備PCIE 的較新機器型的Q35
QEMU64=QEMU64
random mac, you can supply your own=隨機MAC ，您可以自行設定
re-generate random mac address=重新生成隨機MAC 地址
Remove LibreELEC image=移除LibreELEC 映像
Remove OpenELEC image=移除OpenELEC 映像
Remove this LibreELEC file=移除此LibreELEC 文件
Remove this OpenELEC file=移除此OpenELEC 文件
SeaBIOS will work for most=SeaBIOS 將適用於大多數
SeaBIOS=SeaBIOS
Select the BIOS=選擇BIOS
Select the LibreELEC version to use=選擇要使用的LibreELEC 版本
Select the machine model=選擇機器型號
Select the OpenELEC version to use=選擇要使用的OpenELEC 版本
Select the USB Controller to emulate=選擇要模擬的USB 控制器
Separate sub-folder and image will be created based on Name=基於名稱創建獨立子文件夾和映像
shares=共享
Some OSes wont support USB3=某些操作系統不支持USB3
Sound Card=聲卡
Start All=全部啟動
Start VM after creation=創建後啟動虛擬機
Stop All=全部停止
Toggle VM autostart=切換虛擬機自動啟動
type of storage image=存儲映像檔類型
Unknown action=未知操作
Unknown version=未知版本
Unraid Mount tag=Unraid 掛載標籤
Unraid Share=Unraid 共享
Updating=正在更新
USB Controller=USB 控制器
USB Devices=USB 設備
vDisk Bus=虛擬磁盤總線
vDisk Location=虛擬磁盤位置
vDisk Size=虛擬磁盤大小
vDisk Type=虛擬磁盤類型
vDisks=虛擬磁盤
video for VNC=VNC 視頻
VirtIO Drivers CDRom Bus=VirtIO 驅動程序光盤總線
VirtIO Drivers ISO=VirtIO 驅動程序ISO
Virtual Machines=虛擬機
VM Console enable Copypaste=VM Console enable Copy/paste
VM creation error=虛擬機創建錯誤
VM image deletion error=虛擬機映像刪除錯誤
VNC Keyboard=VNC 鍵盤
VNC Password=VNC 密碼
VNC Video Driver=VNC 視頻驅動程序
VNC=VNC
Wasnt able to stop the process=無法停止該進程
Windows 7XP=Windows 7/XP
Windows 82012, newer Linux distros=Windows 8/2012，新的Linux 發行版
XML View=XML 視圖

; Note: April 28, 2023 - 43 missing translations
9p Mode=
Boot Order=
Boot order=
define OS boot options=
Eject CD Drive=
Enable USB boot=
ETA=
Guest agent not installed=
Guest not running or guest agent not installed=
Guest not running=
Insert CD=
Insert=
Interfaces=
Invalid storage path=
IP Address=
ISO Image=
Lock sortable items=
Network Model=
Network Source=
No CD image inserted in to drive=
Optional=
OVMF TPM=
port for virtual console=
Prefix=
protocol for virtual console=
Select=
Serial=
Specify a ISO storage path first=
Unlock sortable items=
Unraid Mount Tag=
Unraid Share Mode=
Unraid Source Path=
Verifying=
Virtiofs Mode=
Virtual=
VM Console AutoPort=
VM Console Keyboard=
VM Console Password=
VM Console Port=
VM Console Protocol=
VM Console Video Driver=
VM Console WS Port=
wsport for virtual console=
